10 20
0 22 22 22 22 22 22 22 22 0
20 0 0 0 22 0 0 0 0 22
22 0 0 0 22 0 0 0 0 22
22 0 0 0 22 0 0 0 0 22
22 0 0 0 0 0 0 0 0 22
22 0 22 22 22 0 0 0 0 22
22 0 0 0 0 0 0 0 0 22
22 0 0 0 0 0 0 0 0 22
22 0 0 0 0 0 0 0 0 22
0 22 22 0 22 22 22 22 22 0
0 22 22 0 22 22 22 22 22 0
0 0 22 0 22 0 0 0 0 0
0 0 22 0 22 0 0 0 0 0
0 0 22 0 22 0 0 0 0 0
0 0 22 0 22 0 0 0 0 0
0 0 22 0 22 0 0 0 0 0
0 0 22 0 22 0 0 0 0 0
0 0 22 0 22 0 0 0 0 0
0 0 22 0 22 0 0 0 0 0
0 0 22 22 22 0 0 0 0 0

1 2 5
3 0 3
3 0 10.7 1
9 0 9 0
4 0 4 1 3
5 0 4 2 2
6 0 4 2 1.5
4 0 6 2 1
4 0 7 5 0.4
