241
0 0 2 0 0 -2 2 0 0 0
2 0 0 0 2 0 0 0 2 22
4 0 2 0 2 0 -2 0 0 22
6 0 2 0 2 0 -2 0 0 22
8 0 2 0 2 0 -2 0 0 22
12 0 2 0 2 0 -2 0 0 22
14 0 2 0 2 0 -2 0 0 22
16 0 2 0 2 0 -2 0 0 22
18 0 0 0 2 0 0 0 2 22
18 0 2 0 2 0 -2 0 0 22
18 0 2 0 0 -2 2 0 0 0
0 0 2 0 2 0 2 0 0 22
2 0 2 0 2 0 0 0 2 22
2 0 4 0 0 -2 2 0 0 0
4 0 4 0 0 -2 2 0 0 0
6 0 4 0 0 -2 2 0 0 0
8 0 2 0 2 0 0 0 2 22
10 0 2 0 2 0 0 0 2 22
10 0 4 0 0 -2 2 0 0 0
12 0 4 0 0 -2 2 0 0 0
14 0 4 0 0 -2 2 0 0 0
16 0 4 0 0 -2 2 0 0 0
18 0 2 0 2 0 0 0 2 22
18 0 2 0 2 0 2 0 0 22
2 0 4 0 2 0 0 0 2 22
2 0 6 0 0 -2 2 0 0 0
4 0 6 0 0 -2 2 0 0 0
6 0 6 0 0 -2 2 0 0 0
8 0 4 0 2 0 0 0 2 22
10 0 4 0 2 0 0 0 2 22
10 0 6 0 0 -2 2 0 0 0
12 0 6 0 0 -2 2 0 0 0
14 0 6 0 0 -2 2 0 0 0
16 0 6 0 0 -2 2 0 0 0
18 0 4 0 2 0 0 0 2 22
2 0 6 0 2 0 0 0 2 22
2 0 8 0 0 -2 2 0 0 0
4 0 8 0 0 -2 2 0 0 0
6 0 8 0 0 -2 2 0 0 0
8 0 6 0 2 0 0 0 2 22
10 0 6 0 2 0 0 0 2 22
10 0 8 0 2 0 -2 0 0 22
10 0 8 0 0 -2 2 0 0 0
12 0 8 0 0 -2 2 0 0 0
14 0 8 0 0 -2 2 0 0 0
16 0 8 0 0 -2 2 0 0 0
18 0 6 0 2 0 0 0 2 22
2 0 8 0 2 0 0 0 2 22
2 0 10 0 0 -2 2 0 0 0
4 0 10 0 0 -2 2 0 0 0
6 0 10 0 0 -2 2 0 0 0
8 0 10 0 0 -2 2 0 0 0
10 0 10 0 0 -2 2 0 0 0
12 0 10 0 0 -2 2 0 0 0
14 0 10 0 0 -2 2 0 0 0
16 0 10 0 0 -2 2 0 0 0
18 0 8 0 2 0 0 0 2 22
2 0 10 0 2 0 0 0 2 22
2 0 12 0 0 -2 2 0 0 0
4 0 10 0 2 0 0 0 2 22
4 0 10 0 2 0 2 0 0 22
6 0 12 0 2 0 -2 0 0 22
6 0 10 0 2 0 2 0 0 22
8 0 12 0 2 0 -2 0 0 22
8 0 10 0 2 0 2 0 0 22
10 0 10 0 2 0 0 0 2 22
10 0 12 0 2 0 -2 0 0 22
10 0 12 0 0 -2 2 0 0 0
12 0 12 0 0 -2 2 0 0 0
14 0 12 0 0 -2 2 0 0 0
16 0 12 0 0 -2 2 0 0 0
18 0 10 0 2 0 0 0 2 22
2 0 12 0 2 0 0 0 2 22
2 0 14 0 0 -2 2 0 0 0
4 0 14 0 0 -2 2 0 0 0
6 0 14 0 0 -2 2 0 0 0
8 0 14 0 0 -2 2 0 0 0
10 0 14 0 0 -2 2 0 0 0
12 0 14 0 0 -2 2 0 0 0
14 0 14 0 0 -2 2 0 0 0
16 0 14 0 0 -2 2 0 0 0
18 0 12 0 2 0 0 0 2 22
2 0 14 0 2 0 0 0 2 22
2 0 16 0 0 -2 2 0 0 0
4 0 16 0 0 -2 2 0 0 0
6 0 16 0 0 -2 2 0 0 0
8 0 16 0 0 -2 2 0 0 0
10 0 16 0 0 -2 2 0 0 0
12 0 16 0 0 -2 2 0 0 0
14 0 16 0 0 -2 2 0 0 0
16 0 16 0 0 -2 2 0 0 0
18 0 14 0 2 0 0 0 2 22
2 0 16 0 2 0 0 0 2 22
2 0 18 0 2 0 -2 0 0 22
2 0 18 0 0 -2 2 0 0 0
4 0 18 0 0 -2 2 0 0 0
6 0 18 0 0 -2 2 0 0 0
8 0 18 0 0 -2 2 0 0 0
10 0 18 0 0 -2 2 0 0 0
12 0 18 0 0 -2 2 0 0 0
14 0 18 0 0 -2 2 0 0 0
16 0 18 0 0 -2 2 0 0 0
18 0 16 0 2 0 0 0 2 22
20 0 18 0 2 0 -2 0 0 22
0 0 20 0 0 -2 2 0 0 0
2 0 18 0 2 0 0 0 2 22
2 0 18 0 2 0 2 0 0 22
4 0 20 0 2 0 -2 0 0 22
4 0 18 0 2 0 2 0 0 22
6 0 18 0 2 0 0 0 2 22
6 0 20 0 0 -2 2 0 0 0
8 0 18 0 2 0 0 0 2 22
8 0 18 0 2 0 2 0 0 22
10 0 18 0 2 0 2 0 0 22
12 0 20 0 2 0 -2 0 0 22
12 0 18 0 2 0 2 0 0 22
14 0 20 0 2 0 -2 0 0 22
14 0 18 0 2 0 2 0 0 22
16 0 20 0 2 0 -2 0 0 22
16 0 18 0 2 0 2 0 0 22
18 0 18 0 2 0 0 0 2 22
18 0 20 0 2 0 -2 0 0 22
18 0 20 0 0 -2 2 0 0 0
0 0 22 0 0 -2 2 0 0 0
2 0 22 0 0 -2 2 0 0 0
4 0 20 0 2 0 0 0 2 22
6 0 20 0 2 0 0 0 2 22
6 0 22 0 0 -2 2 0 0 0
8 0 20 0 2 0 0 0 2 22
10 0 20 0 2 0 0 0 2 22
10 0 22 0 0 -2 2 0 0 0
12 0 22 0 0 -2 2 0 0 0
14 0 22 0 0 -2 2 0 0 0
16 0 22 0 0 -2 2 0 0 0
18 0 22 0 0 -2 2 0 0 0
0 0 24 0 0 -2 2 0 0 0
2 0 24 0 0 -2 2 0 0 0
4 0 22 0 2 0 0 0 2 22
6 0 22 0 2 0 0 0 2 22
6 0 24 0 0 -2 2 0 0 0
8 0 22 0 2 0 0 0 2 22
10 0 22 0 2 0 0 0 2 22
10 0 24 0 0 -2 2 0 0 0
12 0 24 0 0 -2 2 0 0 0
14 0 24 0 0 -2 2 0 0 0
16 0 24 0 0 -2 2 0 0 0
18 0 24 0 0 -2 2 0 0 0
0 0 26 0 0 -2 2 0 0 0
2 0 26 0 0 -2 2 0 0 0
4 0 24 0 2 0 0 0 2 22
6 0 24 0 2 0 0 0 2 22
6 0 26 0 0 -2 2 0 0 0
8 0 24 0 2 0 0 0 2 22
10 0 24 0 2 0 0 0 2 22
10 0 26 0 0 -2 2 0 0 0
12 0 26 0 0 -2 2 0 0 0
14 0 26 0 0 -2 2 0 0 0
16 0 26 0 0 -2 2 0 0 0
18 0 26 0 0 -2 2 0 0 0
0 0 28 0 0 -2 2 0 0 0
2 0 28 0 0 -2 2 0 0 0
4 0 26 0 2 0 0 0 2 22
6 0 26 0 2 0 0 0 2 22
6 0 28 0 0 -2 2 0 0 0
8 0 26 0 2 0 0 0 2 22
10 0 26 0 2 0 0 0 2 22
10 0 28 0 0 -2 2 0 0 0
12 0 28 0 0 -2 2 0 0 0
14 0 28 0 0 -2 2 0 0 0
16 0 28 0 0 -2 2 0 0 0
18 0 28 0 0 -2 2 0 0 0
0 0 30 0 0 -2 2 0 0 0
2 0 30 0 0 -2 2 0 0 0
4 0 28 0 2 0 0 0 2 22
6 0 28 0 2 0 0 0 2 22
6 0 30 0 0 -2 2 0 0 0
8 0 28 0 2 0 0 0 2 22
10 0 28 0 2 0 0 0 2 22
10 0 30 0 0 -2 2 0 0 0
12 0 30 0 0 -2 2 0 0 0
14 0 30 0 0 -2 2 0 0 0
16 0 30 0 0 -2 2 0 0 0
18 0 30 0 0 -2 2 0 0 0
0 0 32 0 0 -2 2 0 0 0
2 0 32 0 0 -2 2 0 0 0
4 0 30 0 2 0 0 0 2 22
6 0 30 0 2 0 0 0 2 22
6 0 32 0 0 -2 2 0 0 0
8 0 30 0 2 0 0 0 2 22
10 0 30 0 2 0 0 0 2 22
10 0 32 0 0 -2 2 0 0 0
12 0 32 0 0 -2 2 0 0 0
14 0 32 0 0 -2 2 0 0 0
16 0 32 0 0 -2 2 0 0 0
18 0 32 0 0 -2 2 0 0 0
0 0 34 0 0 -2 2 0 0 0
2 0 34 0 0 -2 2 0 0 0
4 0 32 0 2 0 0 0 2 22
6 0 32 0 2 0 0 0 2 22
6 0 34 0 0 -2 2 0 0 0
8 0 32 0 2 0 0 0 2 22
10 0 32 0 2 0 0 0 2 22
10 0 34 0 0 -2 2 0 0 0
12 0 34 0 0 -2 2 0 0 0
14 0 34 0 0 -2 2 0 0 0
16 0 34 0 0 -2 2 0 0 0
18 0 34 0 0 -2 2 0 0 0
0 0 36 0 0 -2 2 0 0 0
2 0 36 0 0 -2 2 0 0 0
4 0 34 0 2 0 0 0 2 22
6 0 34 0 2 0 0 0 2 22
6 0 36 0 0 -2 2 0 0 0
8 0 34 0 2 0 0 0 2 22
10 0 34 0 2 0 0 0 2 22
10 0 36 0 0 -2 2 0 0 0
12 0 36 0 0 -2 2 0 0 0
14 0 36 0 0 -2 2 0 0 0
16 0 36 0 0 -2 2 0 0 0
18 0 36 0 0 -2 2 0 0 0
0 0 38 0 0 -2 2 0 0 0
2 0 38 0 0 -2 2 0 0 0
4 0 36 0 2 0 0 0 2 22
6 0 36 0 2 0 0 0 2 22
6 0 38 0 0 -2 2 0 0 0
8 0 36 0 2 0 0 0 2 22
10 0 36 0 2 0 0 0 2 22
10 0 38 0 0 -2 2 0 0 0
12 0 38 0 0 -2 2 0 0 0
14 0 38 0 0 -2 2 0 0 0
16 0 38 0 0 -2 2 0 0 0
18 0 38 0 0 -2 2 0 0 0
0 0 40 0 0 -2 2 0 0 0
2 0 40 0 0 -2 2 0 0 0
4 0 38 0 2 0 0 0 2 22
6 0 38 0 2 0 2 0 0 22
10 0 38 0 2 0 0 0 2 22
10 0 40 0 0 -2 2 0 0 0
12 0 40 0 0 -2 2 0 0 0
14 0 40 0 0 -2 2 0 0 0
16 0 40 0 0 -2 2 0 0 0
18 0 40 0 0 -2 2 0 0 0
1 1 4 1 10 
3 0 3
3 0 11 1
16 0 9 5 3
7 0 36 5 3
5 0 15 5 3
14 0 5 5 3
5 0 10 0
10.0 0 1.0 -8.0 -1 -1.0 8.0 1 1.0
1.0 0 10.0 -1.0 -1 -8.0 1.0 1 8.0
9.0 0 5.0 -1.0 -1 -3.0 1.0 1 3.0
19.0 0 10.0 -1.0 -1 -8.0 1.0 1 8.0
7.0 0 11.0 -3.0 -1 -1.0 3.0 1 1.0
4.0 0 19.0 -2.0 -1 -1.0 2.0 1 1.0
9.0 0 29.0 -1.0 -1 -11.0 1.0 1 11.0
14.0 0 19.0 -4.0 -1 -1.0 4.0 1 1.0
5.0 0 30.0 -1.0 -1 -10.0 1.0 1 10.0
8.0 0 39.0 -2.0 -1 -1.0 2.0 1 1.0
