200
0 0 0 2 0 0 2 0 2 0
2 0 0 4 0 0 4 0 2 22
4 0 0 6 0 0 6 0 2 22
6 0 0 8 0 0 8 0 2 22
8 0 0 10 0 0 10 0 2 22
10 0 0 12 0 0 12 0 2 22
12 0 0 14 0 0 14 0 2 22
14 0 0 16 0 0 16 0 2 22
16 0 0 18 0 0 18 0 2 22
18 0 0 20 0 0 20 0 2 0
0 0 2 2 0 2 2 0 4 22
2 0 2 4 0 2 4 0 4 0
4 0 2 6 0 2 6 0 4 0
6 0 2 8 0 2 8 0 4 0
8 0 2 10 0 2 10 0 4 22
10 0 2 12 0 2 12 0 4 0
12 0 2 14 0 2 14 0 4 0
14 0 2 16 0 2 16 0 4 0
16 0 2 18 0 2 18 0 4 0
18 0 2 20 0 2 20 0 4 22
0 0 4 2 0 4 2 0 6 22
2 0 4 4 0 4 4 0 6 0
4 0 4 6 0 4 6 0 6 0
6 0 4 8 0 4 8 0 6 0
8 0 4 10 0 4 10 0 6 22
10 0 4 12 0 4 12 0 6 0
12 0 4 14 0 4 14 0 6 0
14 0 4 16 0 4 16 0 6 0
16 0 4 18 0 4 18 0 6 0
18 0 4 20 0 4 20 0 6 22
0 0 6 2 0 6 2 0 8 22
2 0 6 4 0 6 4 0 8 0
4 0 6 6 0 6 6 0 8 0
6 0 6 8 0 6 8 0 8 0
8 0 6 10 0 6 10 0 8 22
10 0 6 12 0 6 12 0 8 0
12 0 6 14 0 6 14 0 8 0
14 0 6 16 0 6 16 0 8 0
16 0 6 18 0 6 18 0 8 0
18 0 6 20 0 6 20 0 8 22
0 0 8 2 0 8 2 0 10 22
2 0 8 4 0 8 4 0 10 0
4 0 8 6 0 8 6 0 10 0
6 0 8 8 0 8 8 0 10 0
8 0 8 10 0 8 10 0 10 0
10 0 8 12 0 8 12 0 10 0
12 0 8 14 0 8 14 0 10 0
14 0 8 16 0 8 16 0 10 0
16 0 8 18 0 8 18 0 10 0
18 0 8 20 0 8 20 0 10 22
0 0 10 2 0 10 2 0 12 22
2 0 10 4 0 10 4 0 12 0
4 0 10 6 0 10 6 0 12 22
6 0 10 8 0 10 8 0 12 22
8 0 10 10 0 10 10 0 12 22
10 0 10 12 0 10 12 0 12 0
12 0 10 14 0 10 14 0 12 0
14 0 10 16 0 10 16 0 12 0
16 0 10 18 0 10 18 0 12 0
18 0 10 20 0 10 20 0 12 22
0 0 12 2 0 12 2 0 14 22
2 0 12 4 0 12 4 0 14 0
4 0 12 6 0 12 6 0 14 0
6 0 12 8 0 12 8 0 14 0
8 0 12 10 0 12 10 0 14 0
10 0 12 12 0 12 12 0 14 0
12 0 12 14 0 12 14 0 14 0
14 0 12 16 0 12 16 0 14 0
16 0 12 18 0 12 18 0 14 0
18 0 12 20 0 12 20 0 14 22
0 0 14 2 0 14 2 0 16 22
2 0 14 4 0 14 4 0 16 0
4 0 14 6 0 14 6 0 16 0
6 0 14 8 0 14 8 0 16 0
8 0 14 10 0 14 10 0 16 0
10 0 14 12 0 14 12 0 16 0
12 0 14 14 0 14 14 0 16 0
14 0 14 16 0 14 16 0 16 0
16 0 14 18 0 14 18 0 16 0
18 0 14 20 0 14 20 0 16 22
0 0 16 2 0 16 2 0 18 22
2 0 16 4 0 16 4 0 18 0
4 0 16 6 0 16 6 0 18 0
6 0 16 8 0 16 8 0 18 0
8 0 16 10 0 16 10 0 18 0
10 0 16 12 0 16 12 0 18 0
12 0 16 14 0 16 14 0 18 0
14 0 16 16 0 16 16 0 18 0
16 0 16 18 0 16 18 0 18 0
18 0 16 20 0 16 20 0 18 22
0 0 18 2 0 18 2 0 20 0
2 0 18 4 0 18 4 0 20 22
4 0 18 6 0 18 6 0 20 22
6 0 18 8 0 18 8 0 20 0
8 0 18 10 0 18 10 0 20 22
10 0 18 12 0 18 12 0 20 22
12 0 18 14 0 18 14 0 20 22
14 0 18 16 0 18 16 0 20 22
16 0 18 18 0 18 18 0 20 22
18 0 18 20 0 18 20 0 20 0
0 0 20 2 0 20 2 0 22 0
2 0 20 4 0 20 4 0 22 0
4 0 20 6 0 20 6 0 22 22
6 0 20 8 0 20 8 0 22 0
8 0 20 10 0 20 10 0 22 22
10 0 20 12 0 20 12 0 22 0
12 0 20 14 0 20 14 0 22 0
14 0 20 16 0 20 16 0 22 0
16 0 20 18 0 20 18 0 22 0
18 0 20 20 0 20 20 0 22 0
0 0 22 2 0 22 2 0 24 0
2 0 22 4 0 22 4 0 24 0
4 0 22 6 0 22 6 0 24 22
6 0 22 8 0 22 8 0 24 0
8 0 22 10 0 22 10 0 24 22
10 0 22 12 0 22 12 0 24 0
12 0 22 14 0 22 14 0 24 0
14 0 22 16 0 22 16 0 24 0
16 0 22 18 0 22 18 0 24 0
18 0 22 20 0 22 20 0 24 0
0 0 24 2 0 24 2 0 26 0
2 0 24 4 0 24 4 0 26 0
4 0 24 6 0 24 6 0 26 22
6 0 24 8 0 24 8 0 26 0
8 0 24 10 0 24 10 0 26 22
10 0 24 12 0 24 12 0 26 0
12 0 24 14 0 24 14 0 26 0
14 0 24 16 0 24 16 0 26 0
16 0 24 18 0 24 18 0 26 0
18 0 24 20 0 24 20 0 26 0
0 0 26 2 0 26 2 0 28 0
2 0 26 4 0 26 4 0 28 0
4 0 26 6 0 26 6 0 28 22
6 0 26 8 0 26 8 0 28 0
8 0 26 10 0 26 10 0 28 22
10 0 26 12 0 26 12 0 28 0
12 0 26 14 0 26 14 0 28 0
14 0 26 16 0 26 16 0 28 0
16 0 26 18 0 26 18 0 28 0
18 0 26 20 0 26 20 0 28 0
0 0 28 2 0 28 2 0 30 0
2 0 28 4 0 28 4 0 30 0
4 0 28 6 0 28 6 0 30 22
6 0 28 8 0 28 8 0 30 0
8 0 28 10 0 28 10 0 30 22
10 0 28 12 0 28 12 0 30 0
12 0 28 14 0 28 14 0 30 0
14 0 28 16 0 28 16 0 30 0
16 0 28 18 0 28 18 0 30 0
18 0 28 20 0 28 20 0 30 0
0 0 30 2 0 30 2 0 32 0
2 0 30 4 0 30 4 0 32 0
4 0 30 6 0 30 6 0 32 22
6 0 30 8 0 30 8 0 32 0
8 0 30 10 0 30 10 0 32 22
10 0 30 12 0 30 12 0 32 0
12 0 30 14 0 30 14 0 32 0
14 0 30 16 0 30 16 0 32 0
16 0 30 18 0 30 18 0 32 0
18 0 30 20 0 30 20 0 32 0
0 0 32 2 0 32 2 0 34 0
2 0 32 4 0 32 4 0 34 0
4 0 32 6 0 32 6 0 34 22
6 0 32 8 0 32 8 0 34 0
8 0 32 10 0 32 10 0 34 22
10 0 32 12 0 32 12 0 34 0
12 0 32 14 0 32 14 0 34 0
14 0 32 16 0 32 16 0 34 0
16 0 32 18 0 32 18 0 34 0
18 0 32 20 0 32 20 0 34 0
0 0 34 2 0 34 2 0 36 0
2 0 34 4 0 34 4 0 36 0
4 0 34 6 0 34 6 0 36 22
6 0 34 8 0 34 8 0 36 0
8 0 34 10 0 34 10 0 36 22
10 0 34 12 0 34 12 0 36 0
12 0 34 14 0 34 14 0 36 0
14 0 34 16 0 34 16 0 36 0
16 0 34 18 0 34 18 0 36 0
18 0 34 20 0 34 20 0 36 0
0 0 36 2 0 36 2 0 38 0
2 0 36 4 0 36 4 0 38 0
4 0 36 6 0 36 6 0 38 22
6 0 36 8 0 36 8 0 38 0
8 0 36 10 0 36 10 0 38 22
10 0 36 12 0 36 12 0 38 0
12 0 36 14 0 36 14 0 38 0
14 0 36 16 0 36 16 0 38 0
16 0 36 18 0 36 18 0 38 0
18 0 36 20 0 36 20 0 38 0
0 0 38 2 0 38 2 0 40 0
2 0 38 4 0 38 4 0 40 0
4 0 38 6 0 38 6 0 40 22
6 0 38 8 0 38 8 0 40 22
8 0 38 10 0 38 10 0 40 22
10 0 38 12 0 38 12 0 40 0
12 0 38 14 0 38 14 0 40 0
14 0 38 16 0 38 16 0 40 0
16 0 38 18 0 38 18 0 40 0
18 0 38 20 0 38 20 0 40 0
1 1 0 0 10 
3 0 3
3 0 11 1
1.0 0 10.0 -1.0 -1 -8.0 1.0 1 8.0
4.0 0 19.0 -2.0 -1 -1.0 2.0 1 1.0
5.0 0 30.0 -1.0 -1 -10.0 1.0 1 10.0
7.0 0 11.0 -3.0 -1 -1.0 3.0 1 1.0
8.0 0 39.0 -2.0 -1 -1.0 2.0 1 1.0
9.0 0 5.0 -1.0 -1 -3.0 1.0 1 3.0
9.0 0 29.0 -1.0 -1 -11.0 1.0 1 11.0
10.0 0 1.0 -8.0 -1 -1.0 8.0 1 1.0
14.0 0 19.0 -4.0 -1 -1.0 4.0 1 1.0
19.0 0 10.0 -1.0 -1 -8.0 1.0 1 8.0
