10 10
0 22 22 22 22 22 22 22 22 0
20 0 0 0 22 0 0 0 0 22
22 0 0 0 22 0 0 0 0 22
22 0 0 0 22 0 0 0 0 22
22 0 0 0 0 0 0 0 0 22
22 0 22 22 22 0 0 0 0 22
22 0 0 0 0 0 0 0 0 22
22 0 0 0 0 0 0 0 0 22
22 0 0 0 0 0 0 0 0 22
0 22 22 22 22 22 22 22 22 0

1 2
3 0 3
3 0 10.7 1
9 0 9 0
