68
8 0 4 8 2 4 6 0 4 22
10 0 4 10 2 4 8 0 4 22
12 0 4 12 2 4 10 0 4 22
14 0 4 14 2 4 12 0 4 22
16 0 4 16 2 4 14 0 4 22
18 0 4 18 2 4 16 0 4 22
20 0 4 20 2 4 18 0 4 22
6 0 4 6 2 4 6 0 6 22
6 0 6 6 0 4 8 0 6 0
8 0 6 8 0 4 10 0 6 0
10 0 6 10 0 4 12 0 6 0
12 0 6 12 0 4 14 0 6 0
14 0 6 14 0 4 16 0 6 0
16 0 6 16 0 4 18 0 6 0
18 0 6 18 0 4 20 0 6 0
20 0 4 20 2 4 20 0 6 22
6 0 6 6 2 6 6 0 8 22
6 0 8 6 0 6 8 0 8 0
8 0 8 8 0 6 10 0 8 0
10 0 8 10 0 6 12 0 8 0
12 0 8 12 0 6 14 0 8 0
14 0 8 14 0 6 16 0 8 0
16 0 8 16 0 6 18 0 8 0
18 0 8 18 0 6 20 0 8 0
20 0 6 20 2 6 20 0 8 22
6 0 8 6 2 8 6 0 10 22
6 0 10 6 0 8 8 0 10 0
8 0 10 8 0 8 10 0 10 0
10 0 10 10 0 8 12 0 10 0
12 0 10 12 0 8 14 0 10 0
14 0 10 14 0 8 16 0 10 0
16 0 10 16 0 8 18 0 10 0
18 0 10 18 0 8 20 0 10 0
20 0 8 20 2 8 20 0 10 22
6 0 10 6 2 10 6 0 12 22
6 0 12 6 0 10 8 0 12 0
8 0 12 8 0 10 10 0 12 0
10 0 12 10 0 10 12 0 12 0
12 0 12 12 0 10 14 0 12 0
14 0 12 14 0 10 16 0 12 0
16 0 12 16 0 10 18 0 12 0
18 0 12 18 0 10 20 0 12 0
20 0 10 20 2 10 20 0 12 22
6 0 12 6 2 12 6 0 14 22
6 0 14 6 0 12 8 0 14 0
8 0 14 8 0 12 10 0 14 0
10 0 14 10 0 12 12 0 14 0
12 0 14 12 0 12 14 0 14 0
14 0 14 14 0 12 16 0 14 0
16 0 14 16 0 12 18 0 14 0
18 0 14 18 0 12 20 0 14 0
20 0 12 20 2 12 20 0 14 22
6 0 14 6 2 14 6 0 16 22
6 0 16 6 0 14 8 0 16 0
8 0 16 8 0 14 10 0 16 0
10 0 16 10 0 14 12 0 16 0
12 0 16 12 0 14 14 0 16 0
14 0 16 14 0 14 16 0 16 0
16 0 16 16 0 14 18 0 16 0
18 0 16 18 0 14 20 0 16 0
20 0 14 20 2 14 20 0 16 22
6 0 16 6 2 16 8 0 16 22
8 0 16 8 2 16 10 0 16 22
10 0 16 10 2 16 12 0 16 22
12 0 16 12 2 16 14 0 16 22
14 0 16 14 2 16 16 0 16 22
16 0 16 16 2 16 18 0 16 22
18 0 16 18 2 16 20 0 16 22
1 0 0 0 8 
8 0 6
13.0 0 3.0 -9.0 -1 -1.0 9.0 1 1.0
5.0 0 11.0 -1.0 -1 -7.0 1.0 1 7.0
21.0 0 11.0 -1.0 -1 -7.0 1.0 1 7.0
14.0 0 17.0 -8.0 -1 -1.0 8.0 1 1.0
13.0 0 3.0 -9.0 -1 -1.0 9.0 1 1.0
5.0 0 11.0 -1.0 -1 -7.0 1.0 1 7.0
21.0 0 11.0 -1.0 -1 -7.0 1.0 1 7.0
14.0 0 17.0 -8.0 -1 -1.0 8.0 1 1.0
