10 20
0 22 22 22 22 22 22 22 22 0
22 0 0 0 22 0 0 0 0 22
22 0 0 0 22 0 0 0 0 22
22 0 0 0 22 0 0 0 0 22
22 0 0 0 0 0 0 0 0 22
22 0 22 22 22 0 0 0 0 22
22 0 0 0 0 0 0 0 0 22
22 0 0 0 0 0 0 0 0 22
22 0 0 0 0 0 0 0 0 22
0 22 22 0 22 22 22 22 22 0
0 22 22 0 22 22 22 22 22 0
0 0 22 0 22 0 0 0 0 0
0 0 22 0 22 0 0 0 0 0
0 0 22 0 22 0 0 0 0 0
0 0 22 0 22 0 0 0 0 0
0 0 22 0 22 0 0 0 0 0
0 0 22 0 22 0 0 0 0 0
0 0 22 0 22 0 0 0 0 0
0 0 22 0 22 0 0 0 0 0
0 0 22 22 22 0 0 0 0 0

1 2 1 1
3 0 3
3 0 10.7 1
9 0 9 0
4 0 7 5 2
5 0 10 0
