10 20
0 22 22 22 22 22 22 22 22 0
22 0 0 0 22 0 0 0 0 22
22 0 0 0 22 0 0 0 0 22
22 0 0 0 22 0 0 0 0 22
22 0 0 0 0 0 0 0 0 22
22 0 22 22 22 0 0 0 0 22
22 0 0 0 0 0 0 0 0 22
22 0 0 0 0 0 0 0 0 22
22 0 0 0 0 0 0 0 0 22
0 22 22 0 22 22 22 22 22 0
0 22 22 0 22 22 22 22 22 0
0 0 22 0 22 0 0 0 0 0
0 0 22 0 22 0 0 0 0 0
0 0 22 0 22 0 0 0 0 0
0 0 22 0 22 0 0 0 0 0
0 0 22 0 22 0 0 0 0 0
0 0 22 0 22 0 0 0 0 0
0 0 22 0 22 0 0 0 0 0
0 0 22 0 22 0 0 0 0 0
0 0 22 22 22 0 0 0 0 0

1 2 15 0
3 0 3
3 0 10.7 1
9 0 9 0
4 0 7 5 2
4 0 7 5 2.5
4 0 7 5 3
4 0 7 5 1.5
4 0 7 5 1.9
4 0 7 5 1.4
4 0 7 5 1.2
4 0 7 5 1.5
4 0 7 5 1.6
4 0 7 5 1.8
4 0 7 5 1.9
4 0 7 5 2.1
4 0 7 5 2.2
4 0 7 5 2.3
4 0 7 5 2.1
