10 10
0 22 22 22 22 22 22 22 22 0
20 0 0 0 0 0 0 0 0 22
22 0 0 0 0 0 0 0 0 22
22 0 0 0 0 0 0 0 0 22
22 0 0 0 0 0 0 0 0 22
22 0 22 22 22 0 0 0 0 22
22 0 0 0 0 0 0 0 0 22
22 0 0 0 0 0 0 0 0 22
22 0 0 0 0 0 0 0 0 22
0 22 22 22 22 22 22 22 22 0

2
player
1
3 0 3
door
1
3 0 10.7
